4 4 4 4 4 4 4 4 4 4 4 4 4 4 4 4 4 4 4 4 4 4 4 4 4 4 4 4 4 4 4 4 4 4 4 4 4 4 4 4 4 4 4 4 4 4 4 4 4 4
4 0 0 0 0 0 0 0 0 0 0 0 0 0 0 0 0 0 0 0 0 0 0 0 0 0 0 0 0 0 0 0 0 0 0 0 0 0 0 0 0 0 0 0 0 0 0 0 0 4
4 0 0 0 1 1 1 1 1 1 1 1 1 1 1 1 1 1 1 1 0 0 0 0 0 0 0 0 4 4 4 4 4 4 4 4 4 4 4 4 4 4 4 4 4 4 0 0 0 4
4 0 0 1 3 1 3 3 1 3 3 3 3 1 3 1 3 3 3 1 1 0 0 0 0 0 0 4 5 5 5 5 5 5 5 4 4 4 4 5 5 5 5 5 5 5 4 0 0 4
4 0 1 1 3 1 1 3 1 3 1 1 3 1 3 1 3 1 1 1 3 1 0 0 0 0 0 4 5 5 5 5 5 5 5 5 5 5 5 5 5 5 5 5 5 5 4 0 0 4
4 0 1 1 3 1 1 3 1 3 3 1 3 1 3 3 3 1 3 1 3 1 0 0 0 0 0 4 5 5 5 5 5 5 5 4 4 4 4 5 5 5 5 5 5 5 4 0 0 4
4 0 1 1 3 1 1 3 1 1 1 1 3 1 1 1 3 1 3 3 3 1 0 0 0 0 0 4 5 5 5 5 5 5 5 4 4 4 4 5 5 5 5 5 5 5 4 0 0 4
4 0 1 1 3 1 1 3 3 3 3 3 3 1 1 3 3 1 3 1 1 1 0 0 0 0 0 4 5 5 5 5 5 5 5 4 4 4 4 5 5 5 5 5 5 5 4 0 0 4
4 0 1 1 3 3 1 3 1 1 1 1 1 1 1 3 1 1 3 1 1 1 0 0 0 0 0 4 5 5 5 5 5 5 5 4 4 4 4 5 5 5 5 5 5 5 4 0 0 4
4 0 1 1 1 3 1 3 3 3 3 3 3 1 1 3 1 1 3 1 1 1 0 0 0 0 0 4 5 5 5 5 5 5 5 4 4 4 4 4 4 4 5 4 4 4 4 0 0 4
4 0 1 3 1 3 1 3 1 1 1 1 3 1 1 3 1 1 3 3 3 1 0 0 0 0 0 4 5 5 5 5 5 5 5 4 4 4 4 4 4 4 5 4 4 4 4 0 0 4
4 0 1 3 1 3 1 3 1 1 1 1 3 3 3 3 1 1 3 1 3 1 0 0 0 0 0 4 4 4 4 4 4 4 4 4 4 4 4 4 4 4 5 4 4 4 4 0 0 4
4 0 1 3 1 3 3 3 1 3 3 3 3 1 1 1 1 3 3 1 3 1 0 0 0 0 0 4 4 5 5 5 5 5 5 4 4 4 5 5 5 5 5 5 5 4 4 0 0 4
4 0 1 3 1 1 1 1 1 3 1 1 1 1 1 1 1 3 1 1 3 1 0 0 0 0 0 4 4 5 5 5 5 5 5 5 5 5 5 5 5 5 5 5 5 4 4 0 0 4
4 0 1 3 1 1 1 1 1 3 1 1 1 1 1 3 3 3 1 1 1 1 0 0 0 0 0 4 4 5 5 5 5 5 5 4 4 4 5 5 5 5 5 5 5 4 4 0 0 4
4 0 1 3 3 3 3 1 1 3 3 3 3 1 1 3 1 1 1 1 1 1 0 0 0 0 0 4 4 4 4 5 5 4 4 4 4 4 5 5 5 5 5 5 5 4 4 0 0 4
4 0 1 1 3 1 3 1 1 1 1 1 3 1 1 3 1 1 3 3 3 1 0 0 0 0 0 4 4 4 4 5 5 4 4 4 4 4 5 5 5 5 5 5 5 4 4 0 0 4
4 0 1 3 3 1 3 3 3 3 1 1 3 1 1 3 1 1 3 1 1 1 0 0 0 0 0 4 4 4 4 5 5 4 4 4 4 4 4 4 4 4 4 4 4 4 4 0 0 4
4 0 1 1 1 1 1 1 1 3 1 1 3 1 1 3 1 1 3 1 1 1 0 0 0 0 0 0 4 4 4 5 5 4 4 4 4 4 4 4 4 4 4 4 4 4 0 0 0 4
4 0 0 1 1 3 3 3 3 3 3 3 3 3 3 3 3 3 3 3 3 0 0 0 0 0 0 0 0 0 0 0 0 0 0 0 0 0 0 0 0 0 0 0 0 0 0 0 0 4
4 0 0 0 1 1 1 1 1 1 1 1 1 1 1 1 1 1 1 1 0 0 0 0 0 0 0 0 0 0 0 0 0 0 0 0 0 0 0 0 0 0 0 0 0 0 0 0 0 4
4 0 0 0 0 0 0 0 0 0 0 0 0 0 0 0 1 1 0 0 0 0 0 0 0 0 0 0 0 0 0 0 0 0 0 0 0 0 0 0 0 0 0 0 0 0 0 0 0 4
4 0 0 0 0 0 0 0 0 0 0 0 0 0 0 0 1 1 0 0 0 0 0 0 0 0 0 0 0 0 0 0 0 0 0 0 0 0 0 0 0 0 0 0 0 0 0 0 0 4
4 0 0 0 0 0 0 0 0 0 0 0 0 0 0 0 1 1 0 0 0 0 0 0 0 0 0 0 0 0 0 0 0 0 0 0 0 0 0 0 0 0 0 0 0 0 0 0 0 4
4 0 0 0 0 0 0 0 0 0 0 0 0 0 0 0 1 1 0 0 0 0 0 0 0 0 0 0 0 0 0 0 0 0 0 0 0 0 0 0 0 0 0 0 0 0 0 0 0 4
4 0 0 0 0 0 0 0 0 0 0 0 0 0 0 0 6 6 8 0 0 0 0 0 0 0 0 0 0 0 0 0 0 0 0 0 0 0 0 0 0 0 0 0 0 0 0 0 0 4
4 0 0 0 0 0 0 0 0 0 0 0 0 0 0 0 9 7 9 0 0 0 0 0 0 0 0 0 0 0 0 0 0 0 0 0 0 0 0 0 0 0 0 0 0 0 0 0 0 4
4 0 0 0 0 0 0 0 0 0 0 0 0 0 0 0 0 1 1 1 0 0 0 0 0 0 0 0 0 0 0 0 0 0 0 0 0 0 0 0 0 0 0 0 0 0 0 0 0 4
4 0 0 0 0 0 0 0 0 0 0 0 0 0 0 0 0 0 1 1 0 0 0 0 0 0 0 0 0 0 0 0 0 0 0 0 0 0 0 0 0 0 0 0 0 0 0 0 0 4
4 0 0 0 0 0 0 0 0 0 0 0 0 0 0 0 0 0 1 1 1 0 0 0 0 0 0 0 0 0 0 0 0 0 0 0 0 4 4 4 4 4 4 4 4 4 4 4 0 4
4 0 0 0 0 0 0 0 0 0 0 0 0 0 0 0 0 0 0 1 1 1 0 0 0 0 0 0 0 0 0 0 0 0 0 0 4 4 4 4 4 4 4 4 4 4 4 4 4 4
4 0 0 0 0 0 0 0 0 0 0 0 0 0 0 0 0 0 0 0 1 1 0 0 0 0 0 0 0 0 0 0 0 0 0 4 4 4 5 5 5 5 5 5 5 5 4 4 4 4
4 0 0 0 0 0 0 0 0 0 0 0 0 0 0 0 0 0 0 1 1 1 1 0 0 0 0 0 0 0 0 0 0 4 4 4 5 5 5 4 4 4 4 4 4 5 4 4 4 4
4 0 0 0 0 0 0 0 0 0 0 0 0 0 0 0 0 0 1 1 1 1 1 1 0 0 0 0 0 0 0 0 0 5 5 5 5 4 4 4 4 4 4 4 4 5 5 5 4 4
4 0 0 0 0 0 0 0 0 0 0 0 0 0 0 0 0 1 1 0 0 1 1 1 0 0 0 0 0 0 0 0 4 5 4 4 4 4 5 5 5 4 4 5 5 5 4 5 4 4
4 0 0 0 0 0 0 0 0 0 0 0 0 0 0 0 1 1 0 0 0 0 1 1 1 1 0 0 0 0 0 4 4 5 4 5 5 5 5 4 5 4 4 5 4 4 4 5 4 4
4 0 0 0 0 0 0 0 0 0 0 0 0 0 8 6 6 0 0 0 0 0 0 0 1 1 0 0 0 0 4 4 4 5 4 5 4 4 4 4 5 4 4 5 5 4 5 5 4 4
4 0 0 0 0 0 0 0 0 0 0 0 0 0 7 7 9 0 0 0 0 0 0 0 6 6 0 0 0 4 4 5 5 5 5 5 4 5 5 5 5 4 4 4 5 4 5 4 4 4
4 0 0 0 0 0 0 0 0 0 0 0 0 1 1 0 0 0 0 0 0 0 0 0 7 7 0 0 0 4 4 5 4 4 4 4 4 5 4 4 5 4 4 4 5 4 5 4 4 4
4 0 0 0 0 0 0 0 0 0 0 0 1 1 0 0 0 0 0 0 0 0 0 0 1 1 1 0 0 4 4 5 4 4 4 4 4 5 4 4 5 5 5 4 5 4 4 4 4 4
4 0 0 0 0 0 0 0 0 0 0 1 1 0 0 0 0 0 0 0 0 0 0 0 0 1 1 0 0 4 4 5 5 5 5 4 4 5 4 4 4 4 5 4 5 5 5 5 4 4
4 0 0 0 0 0 0 0 0 0 0 1 1 0 0 0 0 0 0 0 0 0 0 0 0 1 1 0 0 4 4 5 4 4 5 4 5 5 4 5 5 5 5 4 5 4 4 4 4 4
4 0 0 0 0 0 0 0 0 0 0 1 1 0 0 0 0 0 0 0 0 0 0 0 0 1 1 0 0 4 4 5 4 4 5 4 4 4 4 5 4 5 4 4 5 4 5 5 4 4
4 0 0 0 0 0 0 0 0 0 1 1 1 0 0 0 0 0 0 0 0 0 0 0 0 1 1 0 0 4 4 5 4 4 5 5 5 5 4 5 4 5 5 4 5 4 4 5 4 4
4 0 0 0 0 0 0 0 0 0 1 1 0 0 0 0 0 0 0 0 0 0 0 0 0 1 1 1 0 4 4 5 5 4 4 4 4 5 4 4 4 4 5 4 5 5 5 5 4 4
4 0 0 0 0 0 0 0 0 1 1 0 0 0 0 0 0 0 0 0 0 0 0 0 0 0 1 1 0 4 4 4 5 4 4 4 4 5 5 5 5 4 4 4 4 4 4 4 4 4
4 0 0 0 0 0 0 0 1 1 0 0 0 0 0 0 0 0 0 0 0 0 0 0 0 0 1 1 0 4 4 5 5 4 5 5 5 4 4 4 5 4 5 5 5 4 4 4 4 4
4 0 0 0 0 0 0 1 1 0 0 0 0 0 0 0 0 0 0 0 0 0 0 0 0 0 1 1 0 4 4 5 4 4 5 4 5 5 5 4 5 4 5 4 5 5 5 5 5 4
4 0 0 0 0 0 0 1 1 0 0 0 0 0 0 0 0 0 0 0 0 0 0 0 0 0 1 1 0 0 4 5 5 5 5 4 4 4 5 4 5 5 5 4 4 4 4 5 5 4
4 4 4 4 4 4 4 1 1 4 4 4 4 4 4 4 4 4 4 4 4 4 4 4 4 4 1 1 4 4 4 4 4 4 4 4 4 4 4 4 4 4 4 4 4 4 4 4 4 4



